NO texture/first.xpm
SO texture/wall.xpm
WE texture/wall2.xpm
EA texture/wall3.xpm

F 254, 225, 90
C  176, 196, 250








1111111111111111111
110000001000000000111111111111
1000S000111111111111100000001
1000000000000000000110000001
1100000011111111111111111001
1000000000000000000111110011
1000000000000000000011111001        1111
1111100111111000000011111001111111111001
110000011111100000001111000000000000001
1100000111111111000000000000000000000001
1111110111111111000001111100000000000001
1111111111111111111111111111111111111111

